21 21
+-+-+-+-+-+-+-+-+-+-+
@   |   |   |       |
+-+ + + + +-+ +-+-+ +
|     |     | | |   |
+ +-+-+-+-+ + + + + +
| |   | |   | |   | |
+ +-+ + + +-+ +-+-+ +
|     |   |   |     |
+ +-+-+-+-+ +-+-+ +-+
|   |   |   | |   | |
+-+ + + +-+ + + +-+ +
|   | | |   |     | |
+ +-+ + + +-+-+ + + +
|   | |   |   | | | |
+ + + +-+-+ + +-+ + +
| | |       | |   | |
+-+ +-+-+-+-+ + +-+ +
|   |     |   |     |
+ +-+ + + + +-+-+-+ +
|     | |   |        
+-+-+-+-+-+-+-+-+-+-+